111111111111
122222222221
143422222221
144422222221
122222222221
122222222221
122222222221
122222222221
122222222221
122222222221
122222222221
111111111111